##############??##############
#####           ##############
######## #####################
######## #####################
########A###      123    #####
########                 #####
############             #####
#####################    #####
#####################    #####
#####################    #####
#####################    #####
####           ######    #####
#### ######### ######    #####
#### ######                  ?
#### ######                  ?
#### #########################
#### #########################
#               §     ########
######## #####################
######## ########1############
######## ########A############
########           ###########
######## #####################
########A#####################
######## #####################
######          ##############
##############  ##############
##############  ##############
##############  ##############
##############??##############
Est : room7.level
Sud : room1.level
Ouest : 
Nord : room4.level

A
Pv : 5
Force : 1
Armure : 1

B
Pv : 10
Force : 3
Armure : 2

C
Pv : 20
Force : 5
Armure : 4