##############################
#########    #################
#########    #################
#########    #################
#########    #################
#########    #################
#########    #################
#########  ###################
#########  #######  #       ##
#####               # #     ##
##################  # #     ##
##################  # #     ##
###        #######  # ########
?   ##############  # ########
?   ##############  # ########
##                    ########
##########     ###############
##########     ###############
##########     ########  #####
##             ########  #####
##########     ########  #####
###########  ##########  #####
###########  ##########  #####
###########  #######      ####
###########               ####
####################      ####
####################      ####
####################      ####
##############            ####
##############??##############
Est : 
Sud : room10.level
Ouest : room12.level
Nord : 

A
Pv : 5
Force : 1
Armure : 1

B
Pv : 10
Force : 3
Armure : 2

C
Pv : 20
Force : 5
Armure : 4